student_id,student_name,sub1,sub2,sub3,sub4,sub5,total_marks,grade
1,om,90,85,80,78,88,421,B
2,sai,88,70,56,90,65,369,C
3,ram,74,70,77,75,60,356,C
4,radha,56,60,45,70,55,286,E
5,kishan,80,88,86,87,80,421,B
6,vijay,60,66,65,45,40,276,E
7,ajay,77,78,74,75,72,376,C
8,vikas,50,56,54,25,20,205,F
9,rahul,35,30,50,20,19,154,F
10,parth,50,85,90,60,30,315,D
